44 0 44 0 44 0 44 0 44 0 44 0 44 0 44 0 44 0 44 0 44 0 44 0 44 0 44 0 44 0 44 0 44 0 44 0 44 0 44 0 
44 0 44 0 44 0 44 0 44 0 44 0 44 0 44 0 44 0 44 0 44 0 44 0 44 0 44 0 44 0 44 0 44 0 44 0 44 0 44 0 
44 0 44 0 44 0 44 0 44 0 44 0 44 0 44 0 44 0 44 0 44 0 44 0 44 0 44 0 44 0 44 0 44 0 44 0 44 0 44 0 
44 0 44 0 44 0 44 0 44 0 44 0 44 0 44 0 44 0 44 0 44 0 44 0 44 0 44 0 44 0 44 0 44 0 44 0 44 0 44 0 
44 0 44 0 44 0 44 0 44 0 44 0 44 0 44 0 44 0 44 0 44 0 44 0 44 0 44 0 44 0 44 0 44 0 44 0 44 0 44 0 
44 0 44 0 44 0 44 0 44 0 44 0 44 0 44 0 44 0 44 0 44 0 44 0 44 0 44 0 44 0 44 0 44 0 44 0 44 0 44 0 
44 0 44 0 44 0 44 0 44 0 44 0 44 0 0 1 2 1 2 1 2 1 2 1 4 1 29 0 95 1 44 0 44 0 44 0 44 0 44 0 
44 0 44 0 44 0 44 0 44 0 44 0 0 1 44 0 44 0 44 0 44 0 44 0 25 1 29 0 77 1 75 1 75 1 76 1 44 0 44 0 
44 0 44 0 44 0 44 0 44 0 44 0 42 1 44 0 12 1 13 1 14 1 44 0 25 1 29 0 44 0 44 0 44 0 59 1 44 0 44 0 
44 0 44 0 44 0 44 0 44 0 44 0 21 1 44 0 33 1 40 1 35 1 44 0 25 1 29 0 44 0 44 0 44 0 59 1 44 0 44 0 
44 0 44 0 44 0 44 0 44 0 44 0 21 1 44 0 54 1 55 1 56 1 44 0 25 1 29 0 44 0 44 0 44 0 59 1 75 1 98 1 
44 0 44 0 44 0 44 0 44 0 44 0 63 1 44 0 44 0 44 0 44 0 44 0 25 1 29 0 44 0 44 0 44 0 59 1 44 0 44 0 
44 0 44 0 44 0 44 0 44 0 44 0 84 1 85 1 85 0 85 0 85 0 85 1 88 1 29 0 44 0 44 0 44 0 59 1 44 0 44 0 
90 1 90 1 90 1 44 0 44 0 44 0 81 1 72 0 32 0 32 0 32 0 72 0 81 1 50 0 44 0 44 0 44 0 59 1 44 0 44 0 
27 0 27 0 27 1 44 0 44 0 44 0 44 0 44 0 32 0 32 0 32 0 44 0 44 0 44 0 44 0 44 0 44 0 59 1 44 0 90 1 
27 0 27 0 27 1 44 0 44 0 44 0 44 0 44 0 44 0 44 0 44 0 44 0 44 0 44 0 44 0 44 0 44 0 57 1 90 1 27 1 
27 0 27 0 27 1 90 1 90 1 84 0 85 0 85 0 85 0 85 0 85 0 85 0 85 0 85 0 88 0 90 1 90 1 27 1 27 0 27 0 
27 0 27 0 27 0 27 0 27 1 90 1 90 1 90 1 80 1 80 1 80 1 81 1 81 1 81 1 90 1 27 1 27 0 27 0 27 0 27 0 
27 0 27 0 27 0 27 0 27 0 27 0 27 0 27 0 90 1 90 1 80 1 81 1 81 1 81 1 27 0 27 0 27 0 27 0 27 0 27 0 
27 0 27 0 27 0 27 0 27 0 27 0 27 0 27 0 27 0 27 0 90 1 102 1 90 1 102 1 27 0 27 0 27 0 27 0 27 0 27 0 
$
