0 0 0 0 0 0 0 0 0 0 0 0 0 0 0 0 0 0 0 0 
0 0 0 0 0 0 0 0 0 0 0 0 0 0 0 0 0 0 0 0 
0 0 0 0 0 0 0 0 0 0 0 0 0 0 0 0 0 0 0 0 
0 0 44 0 0 44 0 0 0 0 0 0 0 0 0 0 0 0 0 0 
0 0 44 44 0 1 1 1 1 1 1 1 1 1 1 4 0 0 0 0 
0 0 0 0 21 44 44 44 44 44 44 44 44 44 44 25 0 0 0 0 
0 0 44 44 21 44 44 44 44 44 44 44 44 44 44 25 0 0 0 0 
0 0 0 44 21 44 44 0 2 2 2 2 2 44 44 25 0 0 0 0 
0 0 44 44 21 44 44 21 44 44 44 44 44 44 44 25 0 0 0 0 
0 0 44 44 21 44 44 44 44 44 44 44 44 44 44 25 0 0 0 0 
0 0 0 44 21 44 44 44 44 44 44 44 44 44 44 25 0 0 0 0 
0 0 0 0 21 44 44 44 44 44 44 44 44 44 44 25 0 0 0 0 
0 0 0 44 21 44 44 44 44 44 44 44 44 44 44 25 0 0 0 0 
0 0 0 0 21 44 44 44 44 44 44 44 44 44 44 25 0 0 0 0 
0 0 0 0 21 44 44 3 3 3 3 3 3 3 44 25 0 0 0 0 
0 0 0 0 84 85 85 85 85 85 85 85 86 86 87 88 0 0 0 0 
0 0 0 0 0 0 0 0 0 0 0 8 0 0 0 44 0 0 0 0 
0 0 0 0 0 0 0 0 0 0 0 0 0 0 0 0 0 0 0 0 
0 0 0 0 0 0 0 0 0 0 0 0 0 0 0 0 0 0 0 0 
0 0 0 0 0 0 0 0 0 0 0 0 0 0 0 0 0 0 0 0 
$
